. . . p . .
. . p g . p
s . p . w .
. . p . . .
. . . p p .
. p . . . .